date,DrCr,amount,balance,mode,name,Day,Month,Year,Tday
01-01-22,Db,10000,473292.87,ATM,,1,1,2022,1
01-01-22,Db,10000,463292.87,ATM,,1,1,2022,1
02-01-22,Db,930,462362.87,UPI,AYUBRAJE,2,1,2022,2
07-01-22,Db,2000,460362.87,UPI,ABUTALAH,7,1,2022,3
10-01-22,Db,1000,459362.87,UPI,AGRAWALB,10,1,2022,4
10-01-22,Db,1800,457562.87,UPI,GOASELEC,10,1,2022,4
10-01-22,Db,5000,452562.87,UPI,GOASELEC,10,1,2022,4
10-01-22,Db,3000,449562.87,UPI,AGRAWALB,10,1,2022,4
10-01-22,Cr,2400,451962.87,NEFT,,10,1,2022,4
12-01-22,Cr,1,451963.87,UPI,NAFEESAB,12,1,2022,5
12-01-22,Cr,1000,452963.87,UPI,NAFEESAB,12,1,2022,5
12-01-22,Db,1000,451963.87,UPI,MAHAMMADH,12,1,2022,5
12-01-22,Db,275,451688.87,UPI,PHONEPE,12,1,2022,5
12-01-22,Db,85,451603.87,UPI,PHONEPE,12,1,2022,5
13-01-22,Db,563,451040.87,UPI,FLIPKART,13,1,2022,6
14-01-22,Db,7000,444040.87,UPI,BUDESAHEB,14,1,2022,7
22-01-22,Db,189,443851.87,UPI,FLIPKART,22,1,2022,8
25-01-22,Cr,7.09,443858.96,ECS,,25,1,2022,9
29-01-22,Cr,2400,446258.96,NEFT,,29,1,2022,10
29-01-22,Db,142,446116.96,DEBIT CARD ANNUAL,,29,1,2022,10
01-02-22,Cr,3187,449303.96,SBINT,,1,2,2022,11
02-02-22,Db,750,448553.96,UPI,AYUBRAJE,2,2,2022,12
04-02-22,Db,19600,428953.96,UPI,STATEBAN,4,2,2022,13
04-02-22,Db,10000,418953.96,ATM,,4,2,2022,13
04-02-22,Db,10000,408953.96,ATM,,4,2,2022,13
05-02-22,Cr,52521,461474.96,NEFT,,5,2,2022,14
05-02-22,Db,2000,459474.96,UPI,BUDESAHEB,5,2,2022,14
10-02-22,Db,302,459172.96,UPI,PHONEPE,10,2,2022,15
10-02-22,Db,85,459087.96,UPI,PHONEPE,10,2,2022,15
11-02-22,Cr,2400,461487.96,NEFT,,11,2,2022,16
11-02-22,Db,2000,459487.96,UPI,ABUTALAH,11,2,2022,16
16-02-22,Db,600,458887.96,UPI,BUDESAHEB,16,2,2022,17
21-02-22,Cr,112,458999.96,ECS,,21,2,2022,18
21-02-22,Cr,8,459007.96,ECS,,21,2,2022,18
21-02-22,Db,59,458948.96,STOCK CHRG,,21,2,2022,18
21-02-22,Db,59,458889.96,STOCK CHRG,,21,2,2022,18
21-02-22,Db,21000,437889.96,UPI,ABDULHAME,21,2,2022,18
24-02-22,Db,4080,433809.96,UPI,NAFEESAB,24,2,2022,19
26-02-22,Db,10000,423809.96,ATM,,26,2,2022,20
26-02-22,Db,10000,413809.96,ATM,,26,2,2022,20
01-03-22,Db,500,413309.96,UPI,ABUTALAH,1,3,2022,21
01-03-22,Cr,2400,415709.96,NEFT,,1,3,2022,21
01-03-22,Db,800,414909.96,UPI,AYUBRAJE,1,3,2022,21
04-03-22,Db,1,414908.96,UPI,SANGALLI,4,3,2022,22
04-03-22,Db,5400,409508.96,UPI,SANGALLI,4,3,2022,22
06-03-22,Db,1000,408508.96,UPI,ABUTALAH,6,3,2022,23
07-03-22,Db,89,408419.96,UPI,PHONEPE,7,3,2022,24
09-03-22,Db,500,407919.96,UPI,SANGALLI,9,3,2022,25
10-03-22,Cr,1,407920.96,UPI,NAFEESAB,10,3,2022,26
10-03-22,Cr,11500,419420.96,UPI,NAFEESAB,10,3,2022,26
10-03-22,Db,1000,418420.96,UPI,ABUTALAH,10,3,2022,26
11-03-22,Cr,52601,471021.96,NEFT,,11,3,2022,27
12-03-22,Db,1000,470021.96,UPI,SANGALLI,12,3,2022,28
12-03-22,Db,400,469621.96,UPI,PHONEPE,12,3,2022,28
13-03-22,Db,719,468902.96,UPI,ABUTALAH,13,3,2022,29
16-03-22,Db,1500,467402.96,UPI,ABUTALAH,16,3,2022,30
17-03-22,Cr,2400,469802.96,NEFT,,17,3,2022,31
20-03-22,Db,18,469784.96,SMS CHARGES,,20,3,2022,32
20-03-22,Db,500,469284.96,UPI,SANGALLI,22,3,2022,32
22-03-22,Db,1,469283.96,UPI,KIRNAKUMA,20,3,2022,33
23-03-22,Db,200000,269283.96,CHEQUE,,23,3,2022,34
25-03-22,Db,24000,245283.96,UPI,ABUTALAH,25,3,2022,35
26-03-22,Db,1000,244283.96,UPI,ABUTALAH,26,3,2022,36
28-03-22,Db,10000,234283.96,ATM,,28,3,2022,37
31-03-22,Db,4000,230283.96,UPI,ABUTALAH,31,3,2022,38
02-04-22,Db,992,229291.96,UPI,AYUBRAJE,2,4,2022,39
04-04-22,Cr,2400,231691.96,NEFT,,4,4,2022,40
05-04-22,Db,5200,226491.96,UPI,SANGALLI,5,4,2022,41
06-04-22,Db,200,226291.96,UPI,SANGALLI,6,4,2022,42
07-04-22,Db,138,226153.96,UPI,PHONEPE,7,4,2022,43
11-04-22,Db,200000,26153.96,CHEQUE,,11,4,2022,44
11-04-22,Db,636,25517.96,UPI,PHONEPE,11,4,2022,44
16-04-22,Cr,11500,37017.96,UPI,NAFEESAB,16,4,2022,45
17-04-22,Cr,1,37018.96,IMPS,,17,4,2022,46
17-04-22,Cr,17500,54518.96,IMPS,,17,4,2022,46
21-04-22,Cr,52601,107119.96,NEFT,,21,4,2022,47
23-04-22,Db,2000,105119.96,UPI,ABUTALAH,23,4,2022,48
24-04-22,Db,5500,99619.96,UPI,SANGALLI,24,4,2022,49
27-04-22,Db,1500,98119.96,UPI,MAHAMMADH,27,4,2022,50
28-04-22,Cr,2400,100519.96,NEFT,,28,4,2022,51
29-04-22,Db,1000,99519.96,UPI,ABUTALAH,29,4,2022,52
01-05-22,Cr,2238,101757.96,SBINT,,1,5,2022,53
02-05-22,Db,928,100829.96,UPI,AYUBRAJE,2,5,2022,54
04-05-22,Cr,11500,112329.96,UPI,NAFEESAB,4,5,2022,55
06-05-22,Db,5400,106929.96,UPI,SANGALLI,6,5,2022,56
07-05-22,Cr,53912,160841.96,NEFT,,7,5,2022,57
11-05-22,Cr,1,160842.96,UPI,NAFEESAB,11,5,2022,58
11-05-22,Cr,1000,161842.96,UPI,NAFEESAB,11,5,2022,58
11-05-22,Cr,7.09,161850.05,ECS,,11,5,2022,58
11-05-22,Db,2000,159850.05,UPI,ABUTALICN,11,5,2022,58
12-05-22,Db,10000,149850.05,ATM,,12,5,2022,59
13-05-22,Db,26817,123033.05,UPI,HDFCBANK,13,5,2022,60
13-05-22,Db,104,122929.05,UPI,PHONEPE,13,5,2022,60
13-05-22,Db,549,122380.05,UPI,PHONEPE,13,5,2022,60
18-05-22,Db,2879,119501.05,UPI,PHONEPE,18,5,2022,61
18-05-22,Db,1000,118501.05,UPI,ABUTALAH,18,5,2022,61
25-05-22,Cr,3933,122434.05,NEFT,,25,5,2022,62
25-05-22,Db,500,121934.05,UPI,ABUTALAH,25,5,2022,62
27-05-22,Db,298,121636.05,UPI,FLIPKART,27,5,2022,63
27-05-22,Db,10000,111636.05,ATM,,27,5,2022,63
29-05-22,Db,899,110737.05,UPI,FLIPKART,29,5,2022,64
01-06-22,Cr,11500,122237.05,UPI,NAFEESAB,1,6,2022,65
03-06-22,Cr,53912,176149.05,NEFT,,3,6,2022,66
03-06-22,Db,832,175317.05,UPI,AYUBRAJE,3,6,2022,66
03-06-22,Db,290,175027.05,UPI,FLIPKART,3,6,2022,66
05-06-22,Db,1000,174027.05,UPI,ABUTALAH,5,6,2022,67
08-06-22,Db,87,173940.05,UPI,PHONEPE,8,6,2022,68
09-06-22,Db,26282,147658.05,UPI,DADAKHALA,9,6,2022,69
11-06-22,Db,457,147201.05,UPI,PHONEPE,11,6,2022,70
13-06-22,Db,300,146901.05,UPI,ADINATHM,13,6,2022,71
13-06-22,Cr,7.09,146908.14,ECS,,13,6,2022,71
13-06-22,Db,26940,119968.14,UPI,HDFCBANK,13,6,2022,71
13-06-22,Cr,25000,144968.14,UPI,DADAKHALA,13,6,2022,71
14-06-22,Db,200,144768.14,UPI,ABUTALAH,14,6,2022,72
15-06-22,Cr,1,144769.14,UPI,ABUTALAH,15,6,2022,73
15-06-22,Db,10000,134769.14,ATM,,15,6,2022,73
17-06-22,Db,500,134269.14,UPI,ABUTALAH,17,6,2022,74
19-06-22,Db,18,134251.14,SMS CHARGES,,19,6,2022,75
20-06-22,Db,1500,132751.14,UPI,ABUTALAH,20,6,2022,76
26-06-22,Db,500,132251.14,UPI,ABUTALAH,26,6,2022,77
27-06-22,Cr,22102,154353.14,NEFT,,27,6,2022,78
29-06-22,Db,500,153853.14,UPI,ABUTALAH,29,6,2022,79
01-07-22,Db,26286,127567.14,UPI,HDFCBANK,1,7,2022,80
02-07-22,Cr,11500,139067.14,UPI,NAFEESAB,2,7,2022,81
04-07-22,Db,960,138107.14,UPI,AYUBRAJE,4,7,2022,82
05-07-22,Cr,53712,191819.14,NEFT,,5,7,2022,83
05-07-22,Db,5400,186419.14,UPI,SANGALLI,5,7,2022,83
05-07-22,Db,1800,184619.14,UPI,MAHAMMADH,5,7,2022,83
07-07-22,Db,525,184094.14,UPI,IBRAHIMK,7,7,2022,84
08-07-22,Db,100,183994.14,UPI,PHONEPE,8,7,2022,85
12-07-22,Db,500,183494.14,UPI,ABUTALAH,12,7,2022,86
13-07-22,Db,1450,182044.14,UPI,IBRAHIMK,13,7,2022,87
16-07-22,Db,10000,172044.14,ATM,,16,7,2022,88
17-07-22,Cr,700,172744.14,UPI,ISUFSABA,17,7,2022,89
17-07-22,Cr,1500,174244.14,UPI,ISUFSABA,17,7,2022,89
21-07-22,Db,500,173744.14,UPI,ABUTALAH,21,7,2022,90
23-07-22,Db,496,173248.14,UPI,PHONEPE,23,7,2022,91
28-07-22,Db,2000,171248.14,UPI,ABUTALAH,28,7,2022,92
29-07-22,Db,160000,11248.14,CHEQUE,,29,7,2022,93
01-08-22,Cr,1038,12286.14,SBINT,,1,8,2022,94
01-08-22,Db,627,11659.14,UPI,DOMINOSP,1,8,2022,94
01-08-22,Db,114,11545.14,UPI,DOMINOSP,1,8,2022,94
01-08-22,Cr,11500,23045.14,UPI,NAFEESAB,1,8,2022,94
02-08-22,Db,1000,22045.14,ATM,,2,8,2022,95
02-08-22,Cr,53912,75957.14,NEFT,,2,8,2022,95
03-08-22,Db,1120,74837.14,UPI,AYUBRAJE,3,8,2022,96
03-08-22,Db,26286,48551.14,UPI,HDFCBANK,3,8,2022,96
06-08-22,Db,5000,43551.14,UPI,BUDESAHEB,6,8,2022,97
06-08-22,Db,1000,42551.14,UPI,SANGALLI,6,8,2022,97
07-08-22,Db,422,42129.14,UPI,IBRAHIMK,7,8,2022,98
07-08-22,Db,9000,33129.14,ATM,,7,8,2022,98
07-08-22,Db,5000,28129.14,ATM,,7,8,2022,98
07-08-22,Db,100,28029.14,UPI,PHONEPE,7,8,2022,98
11-08-22,Cr,7.09,28036.23,ECS,,11,8,2022,99
12-08-22,Db,500,27536.23,UPI,ABUTALAH,12,8,2022,100
14-08-22,Db,382,27154.23,UPI,PHONEPE,14,8,2022,101
17-08-22,Db,719,26435.23,UPI,PHONEPE,17,8,2022,102
17-08-22,Db,1000,25435.23,UPI,ABUTALAH,17,8,2022,102
20-08-22,Db,100,25335.23,UPI,NINECITY,20,8,2022,103
22-08-22,Db,2000,23335.23,UPI,MAHAMMADH,22,8,2022,104
22-08-22,Db,938,22397.23,UPI,KOTAKGEN,22,8,2022,104
22-08-22,Cr,938,23335.23,UPI,PHONEPE,22,8,2022,104
23-08-22,Db,1200,22135.23,UPI,ABUTALAH,23,8,2022,105
23-08-22,Db,100,22035.23,UPI,ABUTALAH,23,8,2022,105
26-08-22,Cr,360000,382035.23,FUNDS TRANSFER DEBIT,,26,8,2022,106
29-08-22,Db,1980,380055.23,UPI,BUDESAHEB,29,8,2022,107
01-09-22,Cr,53912,433967.23,NEFT,,1,9,2022,108
01-09-22,Cr,11500,445467.23,UPI,NAFEESAB,1,9,2022,108
02-09-22,Db,26286,419181.23,UPI,HDFCBANK,2,9,2022,109
02-09-22,Db,530,418651.23,UPI,BAJAJFIN,2,9,2022,109
03-09-22,Db,980,417671.23,UPI,AYUBRAJE,3,9,2022,110
05-09-22,Db,6400,411271.23,UPI,SANGALLI,5,9,2022,111
05-09-22,Db,300000,111271.23,CHEQUE,,5,9,2022,111
05-09-22,Db,100,111171.23,UPI,PHONEPE,5,9,2022,111
06-09-22,Db,14000,97171.23,UPI,ABUTALAH,6,9,2022,112
07-09-22,Db,1737.01,95434.22,UPI,1MGHEALT,7,9,2022,113
08-09-22,Cr,191.39,95625.61,UPI,1MGHEALT,8,9,2022,114
09-09-22,Cr,148.53,95774.14,UPI,1MGHEALT,9,9,2022,115
11-09-22,Db,553,95221.14,UPI,PHONEPE,11,9,2022,116
11-09-22,Db,1200,94021.14,UPI,ABUTALAH,11,9,2022,116
12-09-22,Cr,84,94105.14,ECS,,12,9,2022,117
12-09-22,Db,100,94005.14,UPI,ABUTALAH,12,9,2022,117
17-09-22,Db,2000,92005.14,UPI,ABUTALAH,17,9,2022,118
20-09-22,Db,10000,82005.14,ATM,,20,9,2022,119
20-09-22,Cr,2.5,82007.64,ECS,,20,9,2022,119
22-09-22,Db,5500,76507.64,UPI,BUDESAHEB,22,9,2022,120
23-09-22,Cr,7.09,76514.73,ECS,,23,9,2022,121
24-09-22,Db,18,76496.73,SMS CHARGES,,24,9,2022,122
28-09-22,Cr,1,76497.73,IMPS,,28,9,2022,123
30-09-22,Db,37000,39497.73,UPI,ABUTALAH,30,9,2022,124
30-09-22,Cr,53912,93409.73,NEFT,,30,9,2022,124
01-10-22,Db,980,92429.73,UPI,AYUBRAJE,1,10,2022,125
03-10-22,Db,10000,82429.73,ATM,,3,10,2022,126
03-10-22,Db,26286,56143.73,UPI,HDFCBANK,3,10,2022,126
03-10-22,Db,5200,50943.73,UPI,BUDESAHEB,3,10,2022,126
03-10-22,Db,36000,14943.73,UPI,ABUTALAH,3,10,2022,126
04-10-22,Cr,11500,26443.73,UPI,NAFEESAB,4,10,2022,127
09-10-22,Db,100,26343.73,UPI,PHONEPE,9,10,2022,128
12-10-22,Cr,97.02,26440.75,ECS,,12,10,2022,129
15-10-22,Db,145,26295.75,UPI,MAHARANI,15,10,2022,130
16-10-22,Db,10000,16295.75,ATM,,16,10,2022,131
18-10-22,Db,1500,14795.75,UPI,ABUTALAH,18,10,2022,132
23-10-22,Db,2500,12295.75,UPI,ABUTALAH,23,10,2022,133
26-10-22,Db,500,11795.75,UPI,SANGALLI,26,10,2022,134
27-10-22,Cr,5361,17156.75,NEFT,,27,10,2022,135
28-10-22,Db,189,16967.75,UPI,FLIPKART,28,10,2022,136
31-10-22,Db,2000,14967.75,UPI,ABUTALAH,31,10,2022,137
01-11-22,Cr,622,15589.75,SBINT,,1,11,2022,138
01-11-22,Db,549,15040.75,UPI,AMAZONPAY,1,11,2022,138
03-11-22,Cr,41699,56739.75,NEFT,,3,11,2022,139
03-11-22,Cr,11500,68239.75,UPI,NAFEESAB,3,11,2022,139
03-11-22,Db,5400,62839.75,UPI,SANGALLI,3,11,2022,139
04-11-22,Db,805,62034.75,UPI,AYUBRAJE,4,11,2022,140
06-11-22,Db,26286,35748.75,UPI,HDFCBANK,6,11,2022,141
10-11-22,Db,666,35082.75,UPI,PHONEPE,10,11,2022,142
11-11-22,Db,500,34582.75,UPI,ABUTALAH,11,11,2022,143
14-11-22,Db,10000,24582.75,ATM,,14,11,2022,144
15-11-22,Db,1,24581.75,UPI,NANDISHM,15,11,2022,145
15-11-22,Db,6099,18482.75,UPI,NANDISHM,15,11,2022,145
15-11-22,Db,900,17582.75,UPI,NANDISHM,15,11,2022,145
17-11-22,Cr,30919,48501.75,NEFT,,17,11,2022,146
17-11-22,Db,132,48369.75,UPI,FLIPKART,17,11,2022,146
18-11-22,Db,700,47669.75,UPI,BUDESAHEB,18,11,2022,147
19-11-22,Db,1000,46669.75,UPI,ABUTALAH,19,11,2022,148
21-11-22,Db,493,46176.75,UPI,PHONEPE,21,11,2022,149
22-11-22,Db,424,45752.75,UPI,PHONEPE,22,11,2022,150
24-11-22,Cr,33117,78869.75,NEFT,,24,11,2022,151
24-11-22,Db,100,78769.75,UPI,PHONEPE,24,11,2022,151
24-11-22,Db,1000,77769.75,UPI,ABUTALAH,24,11,2022,151
25-11-22,Db,4400,73369.75,UPI,BUDESAHEB,25,11,2022,152
28-11-22,Db,3030,70339.75,UPI,MOMAHADHU,28,11,2022,153
01-12-22,Cr,41299,111638.75,NEFT,,1,12,2022,154
01-12-22,Db,1000,110638.75,UPI,ABUTALAH,1,12,2022,154
02-12-22,Cr,11500,122138.75,UPI,NAFEESAB,2,12,2022,155
03-12-22,Db,26286,95852.75,UPI,HDFCBANK,3,12,2022,156
03-12-22,Db,420,95432.75,UPI,AYUBRAJE,3,12,2022,156
04-12-22,Cr,1,95433.75,UPI,ASGARALI,4,12,2022,157
04-12-22,Cr,4570,100003.75,UPI,ASGARALI,4,12,2022,157
05-12-22,Cr,123.2,100126.95,ECS,,5,12,2022,158
05-12-22,Db,5400,94726.95,UPI,SANGALLI,5,12,2022,158
06-12-22,Db,1500,93226.95,UPI,ABUTALAH,6,12,2022,159
13-12-22,Db,399,92827.95,UPI,PHONEPE,13,12,2022,160
13-12-22,Db,1,92826.95,UPI,HUCHCHAPP,13,12,2022,160
13-12-22,Db,2999,89827.95,UPI,HUCHCHAPP,13,12,2022,160
14-12-22,Db,199,89628.95,UPI,FLIPKART,14,12,2022,161
14-12-22,Cr,1,89629.95,UPI,BHIMANAGO,14,12,2022,161
14-12-22,Cr,1300,90929.95,UPI,BHIMANAGO,14,12,2022,161
14-12-22,Cr,1300,92229.95,UPI,MALATESH,14,12,2022,161
16-12-22,Cr,1300,93529.95,UPI,SHIVANAND,16,12,2022,162
16-12-22,Db,23000,70529.95,UPI,ABUTALAH,16,12,2022,162
20-12-22,Cr,1300,71829.95,UPI,HANAMANTH,20,12,2022,163
21-12-22,Cr,200,72029.95,UPI,RAHILMAN,21,12,2022,164
21-12-22,Db,2000,70029.95,UPI,ABUTALAH,21,12,2022,164
21-12-22,Db,5,70024.95,UPI,SAGAR,21,12,2022,164
22-12-22,Db,4000,66024.95,UPI,MOHAMMEDT,22,12,2022,165
24-12-22,Db,11,66013.95,SMS CHARGES,,24,12,2022,166
24-12-22,Cr,7.09,66021.04,ECS,,24,12,2022,166
24-12-22,Db,1740,64281.04,UPI,RANGOL|S,24,12,2022,166
29-12-22,Db,1000,63281.04,UPI,ABUTALAH,29,12,2022,167
31-12-22,Cr,41699,104980.04,NEFT,,31,12,2022,168
01-01-23,Cr,5,104985.04,UPI,MEHTAMOH,1,1,2023,169
01-01-23,Db,6005,98980.04,UPI,MEHTAMOH,1,1,2023,169
03-01-23,Db,26286,72694.04,UPI,HDFCBANK,3,1,2023,170
04-01-23,Cr,11500,84194.04,UPI,NAFEESAB,4,1,2023,171
05-01-23,Db,5400,78794.04,UPI,SANGALLI,5,1,2023,172
07-01-23,Db,202,78592.04,UPI,PHONEPE,7,1,2023,173
07-01-23,Db,1000,77592.04,UPI,ABUTALAH,7,1,2023,173
10-01-23,Db,400,77192.04,UPI,SAIDUSABI,10,1,2023,174
10-01-23,Db,6000,71192.04,UPI,ABUTALAH,10,1,2023,174
17-01-23,Db,3450,67742.04,UPI,MADANLAL,17,1,2023,175
17-01-23,Db,3000,64742.04,UPI,PRAKASHK,17,1,2023,175
17-01-23,Db,11000,53742.04,UPI,MOHAMMED,17,1,2023,175
17-01-23,Db,500,53242.04,UPI,SANGALLI,17,1,2023,175
17-01-23,Db,600,52642.04,UPI,SANGALLI,17,1,2023,175
18-01-23,Db,1000,51642.04,UPI,ABUTALAH,18,1,2023,176
19-01-23,Cr,7.09,51649.13,ECS,,19,1,2023,177
23-01-23,Db,1,51648.13,UPI,CHANDRAKA,23,1,2023,178
23-01-23,Db,2800,48848.13,UPI,CHANDRAKA,23,1,2023,178
23-01-23,Db,1500,47348.13,UPI,PRATIKC,23,1,2023,178
24-01-23,Cr,10000,57348.13,UPI,NAFEESAB,24,1,2023,179
25-01-23,Db,1,57347.13,UPI,JESARAMG,25,1,2023,180
25-01-23,Db,700,56647.13,UPI,JESARAMG,25,1,2023,180
27-01-23,Db,1000,55647.13,UPI,ABUTALAH,27,1,2023,181
27-01-23,Db,290,55357.13,UPI,RAVIKUMAR,27,1,2023,181
27-01-23,Db,324,55033.13,UPI,UTTAMRAJ,27,1,2023,181
29-01-23,Db,148,54885.13,DEBIT CARD ANNUAL,,29,1,2023,182
30-01-23,Db,1000,53885.13,UPI,SANGALLI,30,1,2023,183
31-01-23,Cr,4570,58455.13,UPI,ASGARALI,31,1,2023,184
31-01-23,Cr,1430,59885.13,UPI,ASGARALI,31,1,2023,184
31-01-23,Db,10000,49885.13,ATM,,31,1,2023,184
31-01-23,Db,10000,39885.13,ATM,,31,1,2023,184
31-01-23,Db,5000,34885.13,ATM,,31,1,2023,184
01-02-23,Cr,476,35361.13,SBINT,,1,2,2023,185
02-02-23,Db,260,35101.13,UPI,SIMABAYl,2,2,2023,186
03-02-23,Db,26286,8815.13,UPI,HDFCBANK,3,2,2023,187
03-02-23,Cr,43236,52051.13,NEFT,,3,2,2023,187
03-02-23,Db,374,51677.13,UPI,PHONEPE,3,2,2023,187
05-02-23,Db,333,51344.13,UPI,PHONEPE,5,2,2023,188
06-02-23,Db,16000,35344.13,UPI,ABDULHAME,6,2,2023,189
08-02-23,Cr,1,35345.13,UPI,NAFEESAB,8,2,2023,190
08-02-23,Cr,11500,46845.13,UPI,NAFEESAB,8,2,2023,190
09-02-23,Db,101,46744.13,UPI,PHONEPE,9,2,2023,191
09-02-23,Db,5000,41744.13,ATM,,9,2,2023,191
10-02-23,Db,1000,40744.13,UPI,ABUTALAH,10,2,2023,192
13-02-23,Db,5000,35744.13,ATM,,13,2,2023,193
16-02-23,Db,5000,30744.13,ATM,,16,2,2023,194
16-02-23,Cr,5000,35744.13,ATM,,16,2,2023,194
16-02-23,Db,5000,30744.13,ATM,,16,2,2023,194
16-02-23,Db,300,30444.13,UPI,MAHAMMADH,16,2,2023,194
21-02-23,Db,1000,29444.13,UPI,ABUTALAH,21,2,2023,195
22-02-23,Cr,4000,33444.13,UPI,MOHAMMEDI,22,2,2023,196
23-02-23,Cr,8,33452.13,ECS,,23,2,2023,197
24-02-23,Cr,119,33571.13,ECS,,24,2,2023,198
28-02-23,Db,33571,0.13,UNKNOWN,,28,2,2023,199
28-02-23,Cr,28386,28386.13,NEFT,,28,2,2023,199
01-03-23,Db,2000,26386.13,UPI,AKHEELAH,1,3,2023,200
02-03-23,Db,1000,25386.13,UPI,MOHAMMEDI,2,3,2023,201
02-03-23,Db,2000,23386.13,UPI,MAHAMMADH,2,3,2023,201
02-03-23,Db,2000,21386.13,UPI,ABUTALAH,2,3,2023,201
03-03-23,Cr,11500,32886.13,UPI,NAFEESAB,3,3,2023,202
04-03-23,Db,699,32187.13,UPI,FLIPKART,4,3,2023,203
04-03-23,Db,436,31751.13,UPI,PHONEPE,4,3,2023,203
05-03-23,Db,26286,5465.13,UPI,HDFCBANK,5,3,2023,204
07-03-23,Db,100,5365.13,UPI,PHONEPE,7,3,2023,205
09-03-23,Cr,1,5366.13,IMPS,,9,3,2023,206
11-03-23,Db,177,5189.13,ECS,,11,3,2023,207
13-03-23,Db,1000,4189.13,UPI,ABUTALAH,13,3,2023,208
26-03-23,Db,12,4177.13,SMS CHARGES,,26,3,2023,209
27-03-23,Db,1000,3177.13,UPI,ABUTALAH,27,3,2023,210
30-03-23,Cr,1000,4177.13,UPI,MOHAMMED,30,3,2023,211
03-04-23,Cr,450,4627.13,NEFT,,3,4,2023,212
03-04-23,Cr,10000,14627.13,UPI,ASGARALI,3,4,2023,212
04-04-23,Db,1000,13627.13,UPI,ABUTALAH,4,4,2023,213
05-04-23,Db,59,13568.13,ATM,,5,4,2023,214
05-04-23,Db,2000,11568.13,ATM,,5,4,2023,214
07-04-23,Db,1000,10568.13,UPI,ABUTALAH,7,4,2023,215
11-04-23,Db,2500,8068.13,UPI,ABUTALAH,11,4,2023,216
11-04-23,Db,5000,3068.13,ATM,,11,4,2023,216
13-04-23,Cr,44136,47204.13,NEFT,,13,4,2023,217
15-04-23,Db,400,46804.13,UPI,KANSINGH,15,4,2023,218
15-04-23,Db,9000,37804.13,ATM,,15,4,2023,218
17-04-23,Db,7800,30004.13,UPI,BUDESAHEB,17,4,2023,219
18-04-23,Cr,25000,55004.13,NEFT,,18,4,2023,220
20-04-23,Db,532,54472.13,UPI,RANGOL|S,20,4,2023,221
20-04-23,Db,225,54247.13,UPI,SUNILSHA,20,4,2023,221
24-04-23,Db,120,54127.13,UPI,ABUTALAH,24,4,2023,222
27-04-23,Db,1129,52998.13,UPI,FLIPKART,27,4,2023,223
27-04-23,Db,45,52953.13,UPI,SHIVANAND,27,4,2023,223
28-04-23,Db,666,52287.13,UPI,PHONEPE,28,4,2023,224
28-04-23,Db,216,52071.13,UPI,FLIPKART,28,4,2023,224
28-04-23,Db,2000,50071.13,UPI,NAFEESAB,28,4,2023,224
28-04-23,Db,1000,49071.13,UPI,ABUTALAH,28,4,2023,224
29-04-23,Db,9000,40071.13,ATM,,29,4,2023,225
01-05-23,Cr,179,40250.13,SBINT,,1,5,2023,226
01-05-23,Db,1500,38750.13,UPI,SHRIGOPA,1,5,2023,226
02-05-23,Cr,25000,63750.13,UPI,NAFEESAB,2,5,2023,227
02-05-23,Cr,5000,68750.13,UPI,MOHAMMEDI,2,5,2023,227
05-05-23,Db,26286,42464.13,UPI,HDFCBANK,5,5,2023,228
06-05-23,Cr,52449,94913.13,NEFT,,6,5,2023,229
07-05-23,Cr,880,95793.13,UPI,SANTOSHI,7,5,2023,230
08-05-23,Db,1520,94273.13,UPI,SUNILKA,8,5,2023,231
11-05-23,Db,9000,85273.13,ATM,,11,5,2023,232
11-05-23,Db,9000,76273.13,ATM,,11,5,2023,232
11-05-23,Db,1000,75273.13,UPI,ABUTALAH,11,5,2023,232
16-05-23,Db,26286,48987.13,UPI,HDFCBANK,16,5,2023,233
18-05-23,Db,666,48321.13,UPI,PHONEPE,18,5,2023,234
18-05-23,Cr,600,48921.13,UPI,RAHILMAN,18,5,2023,234
20-05-23,Db,3000,45921.13,UPI,ABUTALAH,20,5,2023,235
21-05-23,Db,1700,44221.13,UPI,ABUTALAH,21,5,2023,236
23-05-23,Db,4000,40221.13,UPI,MANENTER,23,5,2023,237
23-05-23,Db,2000,38221.13,UPI,NAFEESAB,23,5,2023,237
23-05-23,Cr,550,38771.13,UPI,NAFEESAB,23,5,2023,237
25-05-23,Cr,2200,40971.13,UPI,NAFEESAB,25,5,2023,238
27-05-23,Db,600,40371.13,UPI,NAFEESAB,27,5,2023,239
28-05-23,Db,3000,37371.13,UPI,ABUTALAH,28,5,2023,240
30-05-23,Db,420,36951.13,UPI,HESCOMBI,30,5,2023,241
01-06-23,Cr,49949,86900.13,NEFT,,1,6,2023,242
01-06-23,Db,1000,85900.13,UPI,ABUTALAH,1,6,2023,242
01-06-23,Cr,11500,97400.13,UPI,NAFEESAB,1,6,2023,242
02-06-23,Db,26286,71114.13,UPI,HDFCBANK,2,6,2023,243
02-06-23,Db,9000,62114.13,ATM,,2,6,2023,243
02-06-23,Db,9000,53114.13,ATM,,2,6,2023,243
05-06-23,Db,3020,50094.13,UPI,VINAYAKV,5,6,2023,244
05-06-23,Db,1000,49094.13,UPI,ABUTALAH,5,6,2023,244
05-06-23,Db,1000,48094.13,UPI,ABUTALAH,5,6,2023,244
14-06-23,Db,6977,41117.13,UPI,HDFCBANK,14,6,2023,245
16-06-23,Db,2000,39117.13,UPI,BUDESAHEB,16,6,2023,246
19-06-23,Cr,10000,49117.13,UPI,KOTINATOT,19,6,2023,247
20-06-23,Db,1000,48117.13,UPI,ABUTALAH,20,6,2023,248
21-06-23,Db,1450,46667.13,UPI,IBRAHIMK,21,6,2023,249
21-06-23,Db,440,46227.13,UPI,IBRAHIMK,21,6,2023,249
22-06-23,Db,9000,37227.13,ATM,,22,6,2023,250
24-06-23,Db,12,37215.13,SMS CHARGES,,24,6,2023,251
25-06-23,Db,750,36465.13,UPI,KANSINGH,25,6,2023,252
25-06-23,Db,335,36130.13,UPI,ASHOKHUC,25,6,2023,252
27-06-23,Db,1000,35130.13,UPI,ABUTALAH,27,6,2023,253
29-06-23,Db,18000,17130.13,UPI,ABUTALAH,29,6,2023,254
29-06-23,Db,7000,10130.13,UPI,KHALILABA,29,6,2023,254
02-07-23,Db,340,9790.13,UPI,ASHOKHUC,2,7,2023,255
02-07-23,Db,9000,790.13,ATM,,2,7,2023,255
02-07-23,Cr,9000,9790.13,ATM,,2,7,2023,255
02-07-23,Db,20,9770.13,UPI,ABUTALAH,2,7,2023,255
03-07-23,Db,3020,6750.13,UPI,SUNILKA,3,7,2023,256
03-07-23,Db,6000,750.13,ATM,,3,7,2023,256
04-07-23,Cr,51705,52455.13,NEFT,,4,7,2023,257
04-07-23,Cr,11500,63955.13,UPI,NAFEESAB,4,7,2023,257
05-07-23,Db,500,63455.13,UPI,ABUTALAH,5,7,2023,258
05-07-23,Db,339,63116.13,UPI,FLIPKART,5,7,2023,258
06-07-23,Db,500,62616.13,UPI,ABUTALAH,6,7,2023,259
06-07-23,Db,26286,36330.13,UPI,DADAKHALA,6,7,2023,259
08-07-23,Cr,7000,43330.13,UPI,ASGARALI,8,7,2023,260
08-07-23,Db,7000,36330.13,ATM,,8,7,2023,260
10-07-23,Cr,7.09,36337.22,ECS,,10,7,2023,261
10-07-23,Cr,7.09,36344.31,ECS,,10,7,2023,261
10-07-23,Cr,2000,38344.31,UPI,BUDESAHEB,10,7,2023,261
11-07-23,Db,990,37354.31,UPI,DADAKHALA,11,7,2023,262
11-07-23,Cr,16847,54201.31,UPI,DADAKHALA,11,7,2023,262
12-07-23,Db,964.98,53236.33,UPI,ECOMEXPRE,12,7,2023,263
12-07-23,Cr,9780,63016.33,NEFT,,12,7,2023,263
13-07-23,Db,26847,36169.33,UPI,HDFCBANK,13,7,2023,264
16-07-23,Db,2119,34050.33,UPI,HESCOMBI,16,7,2023,265
17-07-23,Db,260,33790.33,UPI,IBRAHIMK,17,7,2023,266
19-07-23,Db,500,33290.33,UPI,ABUTALAH,19,7,2023,267
20-07-23,Db,220,33070.33,UPI,ASHOKHUC,20,7,2023,268
20-07-23,Db,2000,31070.33,UPI,MAHAMMADH,20,7,2023,268
21-07-23,Db,339,30731.33,UPI,FLIPKART,21,7,2023,269
24-07-23,Db,5000,25731.33,UPI,AKHEELAH,24,7,2023,270
25-07-23,Db,1300,24431.33,UPI,BHAJARANG,25,7,2023,271
25-07-23,Db,5000,19431.33,ATM,,25,7,2023,271
25-07-23,Cr,100,19531.33,UPI,MAHAMMADG,25,7,2023,271
28-07-23,Db,20,19511.33,OTHER,,28,7,2023,272
28-07-23,Db,5000,14511.33,ATM,,28,7,2023,272
31-07-23,Db,3020,11491.33,UPI,SUNILKA,31,7,2023,273
01-08-23,Cr,324,11815.33,SBINT,,1,8,2023,274
02-08-23,Cr,7.09,11822.42,ECS,,2,8,2023,275
03-08-23,Db,10000,1822.42,ATM,,3,8,2023,276
03-08-23,Db,62,1760.42,UPI,JIOINAPP,3,8,2023,276
03-08-23,Db,100,1660.42,UPI,ABUTALAH,3,8,2023,276
04-08-23,Db,223,1437.42,UPI,FLIPKART,4,8,2023,277
04-08-23,Db,722,715.42,UPI,JIOINAPP,4,8,2023,277
09-08-23,Cr,3000,3715.42,UPI,KOTINATOT,9,8,2023,278
09-08-23,Db,2000,1715.42,UPI,ABUTALAH,9,8,2023,278
10-08-23,Db,669,1046.42,UPI,JIOINAPP,10,8,2023,279
12-08-23,Cr,1500,2546.42,UPI,KOTINATOT,12,8,2023,280
12-08-23,Db,2200,346.42,UPI,SANJAYLA,12,8,2023,280
13-08-23,Db,1,345.42,UPI,BANKACCO,13,8,2023,281
16-08-23,Cr,51905,52250.42,NEFT,,16,8,2023,282
17-08-23,Db,26286,25964.42,UPI,HDFCBANK,17,8,2023,283
17-08-23,Db,300,25664.42,UPI,ABUTALAH,17,8,2023,283
18-08-23,Cr,12500,38164.42,UPI,NAFEESAB,18,8,2023,284
27-08-23,Db,450,37714.42,UPI,NAFEESAB,27,8,2023,285
28-08-23,Db,3020,34694.42,UPI,SUNILKA,28,8,2023,286
28-08-23,Cr,2000,36694.42,UPI,MANIYARA,28,8,2023,286
28-08-23,Db,1107,35587.42,UPI,AMAZONPA,28,8,2023,286
28-08-23,Db,9000,26587.42,ATM,,28,8,2023,286
29-08-23,Db,410,26177.42,UPI,ASHOKHUC,29,8,2023,287
30-08-23,Cr,934.16,27111.58,NEFT,,30,8,2023,288
02-09-23,Cr,12500,39611.58,UPI,NAFEESAB,2,9,2023,289
02-09-23,Cr,51905,91516.58,NEFT,,2,9,2023,289
02-09-23,Db,1,91515.58,UPI,DADAKHALA,2,9,2023,289
03-09-23,Db,200,91315.58,UPI,ASHOKHUC,3,9,2023,290
03-09-23,Db,1530,89785.58,UPI,SHRIRAGH,3,9,2023,290
03-09-23,Cr,1,89786.58,UPI,DADAKHALA,3,9,2023,290
04-09-23,Db,200,89586.58,UPI,ABUTALAH,4,9,2023,291
04-09-23,Db,9000,80586.58,ATM,,4,9,2023,291
04-09-23,Db,85,80501.58,UPI,DADAKHALA,4,9,2023,291
05-09-23,Db,26286,54215.58,UPI,DADAKHALA,5,9,2023,292
05-09-23,Db,19,54196.58,UPI,JIOINAPP,5,9,2023,292
06-09-23,Db,5000,49196.58,UPI,NAFEESAB,6,9,2023,293
07-09-23,Cr,1700,50896.58,UPI,KOTINATOT,7,9,2023,294
08-09-23,Db,580,50316.58,UPI,ASHOKHUC,8,9,2023,295
08-09-23,Db,3050,47266.58,UPI,MANAPPURA,8,9,2023,295
08-09-23,Db,5000,42266.58,ATM,,8,9,2023,295
08-09-23,Db,62,42204.58,UPI,JIOINAPP,8,9,2023,295
10-09-23,Db,1500,40704.58,UPI,ABUTALAH,10,9,2023,296
12-09-23,Db,120,40584.58,UPI,ASHOKHUC,12,9,2023,297
12-09-23,Cr,84,40668.58,ECS,,12,9,2023,297
13-09-23,Db,540,40128.58,UPI,FLIPKART,13,9,2023,298
13-09-23,Db,1530,38598.58,UPI,SHRIRAGH,13,9,2023,298
13-09-23,Db,9000,29598.58,ATM,,13,9,2023,298
14-09-23,Cr,37230,66828.58,FUNDS TRANSFER DEBIT,,14,9,2023,299
16-09-23,Db,824,66004.58,UPI,HESCOMBI,16,9,2023,300
17-09-23,Db,888,65116.58,UPI,FLIPKART,17,9,2023,301
17-09-23,Db,793,64323.58,UPI,MEESHO,17,9,2023,301
20-09-23,Db,1700,62623.58,UPI,SHRIRAGH,20,9,2023,302
21-09-23,Db,422,62201.58,UPI,ASHOKHUC,21,9,2023,303
21-09-23,Db,10000,52201.58,ATM,,21,9,2023,303
22-09-23,Db,500,51701.58,UPI,ABUTALAH,22,9,2023,304
23-09-23,Cr,7.09,51708.67,ECS,,23,9,2023,305
23-09-23,Db,17,51691.67,SMS CHARGES,,23,9,2023,305
25-09-23,Db,3020,48671.67,UPI,SUNILKA,25,9,2023,306
25-09-23,Db,500,48171.67,UPI,MAHAMMADH,25,9,2023,306
25-09-23,Db,740,47431.67,UPI,ASHOKHUC,25,9,2023,306
25-09-23,Db,100,47331.67,UPI,ABUTALAH,25,9,2023,306
25-09-23,Db,669,46662.67,UPI,JIOINAPP,25,9,2023,306
27-09-23,Db,10000,36662.67,ATM,,27,9,2023,307
01-10-23,Db,3600,33062.67,UPI,INDIANIN,1,10,2023,308
03-10-23,Db,530,32532.67,UPI,ASHOKHUC,3,10,2023,309
03-10-23,Db,1000,31532.67,UPI,DADAKHALA,3,10,2023,309
04-10-23,Db,26286,5246.67,UPI,DADAKHALA,4,10,2023,310
04-10-23,Db,220,5026.67,UPI,DADAKHALA,4,10,2023,310
04-10-23,Db,286,4740.67,UPI,DADAKHALA,4,10,2023,310
05-10-23,Cr,51905,56645.67,NEFT,,5,10,2023,311
05-10-23,Db,48,56597.67,UPI,AYUBRAJE,5,10,2023,311
06-10-23,Cr,41050,97647.67,CHEQUE,,6,10,2023,312
06-10-23,Cr,107.8,97755.47,ECS,,6,10,2023,312
06-10-23,Cr,23586,121341.47,UPI,DADAKHALA,6,10,2023,312
06-10-23,Db,26286,95055.47,UPI,HDFCBANK,6,10,2023,312
07-10-23,Db,100,94955.47,UPI,LAGADEKSA,7,10,2023,313
07-10-23,Db,100,94855.47,UPI,LAGADEKSA,7,10,2023,313
